96  
52  128
0  0  0  0  0  0  0  0  0  0  0  0  0  0  0  0  0  0  0  0  0  0  0  0  0  0  0  0  0  0  0  0  0  0  0  0  0  0  0  0  0  0  0  0  0  0  0  0  0  0  0  0  0  0  0  0  0  0  0  0  0  0  0  0  0  0  0  0  0  0  0  0  0  0  0  0  0  0  0  0  0  0  0  0  0  0  0  0  0  0  0  0  0  0  0  0  0  0  0  0  0  0  0  0  0  0  0  0  0  0  0  0  0  0  0  0  0  0  0  0  0  0  0  0  0  0  0  0  
0  0  0  0  0  0  0  0  0  0  0  0  0  0  0  0  0  0  0  0  0  0  0  0  0  0  0  0  0  0  0  0  0  0  0  0  0  0  0  0  0  0  0  0  0  0  0  0  0  0  0  0  0  0  0  0  0  0  0  0  0  0  0  0  0  0  0  0  0  0  0  0  0  0  0  0  0  0  0  0  0  0  0  0  0  0  0  0  0  0  0  0  0  0  0  0  0  0  0  0  0  0  0  0  0  0  0  0  0  0  0  0  0  0  0  0  0  0  0  0  0  0  0  0  0  0  0  0  
0  0  0  0  0  0  0  0  0  0  0  0  0  0  0  0  0  0  0  0  0  0  0  0  0  0  0  0  0  0  0  0  0  0  0  0  0  0  0  0  0  0  0  0  0  0  0  0  0  0  0  0  0  0  0  0  0  0  0  0  0  0  0  0  0  0  0  0  0  0  0  0  0  0  0  0  0  0  0  0  0  0  0  0  0  0  0  0  0  0  0  0  0  0  0  0  0  0  0  0  0  0  0  0  0  0  0  0  0  0  0  0  0  0  0  0  0  0  0  0  0  0  0  0  0  0  0  0  
1  1  0  0  0  0  2  3  0  0  0  0  4  5  6  7  6  7  6  7  6  7  6  7  6  7  6  7  6  7  6  7  6  7  6  7  6  7  6  7  6  7  6  7  6  7  1  1  0  0  0  0  0  0  0  0  0  0  0  0  0  0  0  0  0  0  0  0  0  0  0  0  0  0  0  0  0  0  0  0  0  0  0  0  0  0  0  0  0  0  0  0  0  0  0  0  0  0  0  0  0  0  0  0  0  0  0  0  0  0  0  0  0  0  0  0  0  0  0  0  0  0  0  0  0  0  0  0  
1  1  0  0  0  0  8  8  0  0  0  0  9  5  10  11  10  11  12  13  14  15  12  16  17  18  12  16  17  18  12  16  17  18  12  16  17  18  12  16  17  18  12  16  19  20  1  1  0  0  0  0  0  0  0  0  0  0  0  0  0  0  0  0  0  0  0  0  0  0  0  0  0  0  0  0  0  0  0  0  0  0  0  0  0  0  0  0  0  0  0  0  0  0  0  0  0  0  0  0  0  0  0  0  0  0  0  0  0  0  0  0  0  0  0  0  0  0  0  0  0  0  0  0  0  0  0  0  
1  1  0  0  21  22  8  8  21  22  0  0  9  5  6  7  6  7  0  0  4  5  0  0  4  5  0  0  4  5  0  0  4  5  0  0  4  5  0  0  4  5  0  0  20  20  1  1  0  0  0  0  0  0  0  0  0  0  0  0  0  0  0  0  0  0  0  0  0  0  0  0  0  0  0  0  0  0  0  0  0  0  0  0  0  0  0  0  0  0  0  0  0  0  0  0  0  0  0  0  0  0  0  0  0  0  0  0  0  0  0  0  0  0  0  0  0  0  0  0  0  0  0  0  0  0  0  0  
1  1  0  0  23  24  8  8  23  24  0  0  9  5  20  20  20  20  25  26  9  5  25  26  9  5  25  26  9  5  25  26  9  5  25  26  9  5  25  26  9  5  25  26  20  20  1  1  0  0  0  0  0  0  0  0  0  0  0  0  0  0  0  0  0  0  0  0  0  0  0  0  0  0  0  0  0  0  0  0  0  0  0  0  0  0  0  0  0  0  0  0  0  0  0  0  0  0  0  0  0  0  0  0  0  0  0  0  0  0  0  0  0  0  0  0  0  0  0  0  0  0  0  0  0  0  0  0  
1  1  21  22  23  24  8  8  23  24  21  22  9  5  20  20  20  20  27  28  9  5  27  28  9  5  27  28  9  5  27  28  9  5  27  28  9  5  27  28  9  5  27  28  20  20  1  1  0  0  0  0  0  0  0  0  0  0  0  0  0  0  0  0  0  0  0  0  0  0  0  0  0  0  0  0  0  0  0  0  0  0  0  0  0  0  0  0  0  0  0  0  0  0  0  0  0  0  0  0  0  0  0  0  0  0  0  0  0  0  0  0  0  0  0  0  0  0  0  0  0  0  0  0  0  0  0  0  
29  30  23  24  23  24  0  0  23  24  23  24  9  5  20  20  20  20  33  28  9  5  33  28  9  5  33  28  9  5  33  28  9  5  33  28  9  5  33  28  9  5  33  28  20  20  1  1  0  0  0  0  0  0  0  0  0  0  0  0  0  0  0  0  0  0  0  0  0  0  0  0  0  0  0  0  0  0  0  0  0  0  0  0  0  0  0  0  0  0  0  0  0  0  0  0  0  0  0  0  0  0  0  0  0  0  0  0  0  0  0  0  0  0  0  0  0  0  0  0  0  0  0  0  0  0  0  0  
29  34  23  24  23  24  0  0  23  24  23  24  9  5  20  20  20  20  27  28  37  38  27  28  37  38  27  28  37  38  27  28  37  38  27  28  37  38  27  28  37  38  27  28  20  20  1  1  0  0  0  0  0  0  0  0  0  0  0  0  0  0  0  0  0  0  0  0  0  0  0  0  0  0  0  0  0  0  0  0  0  0  0  0  0  0  0  0  0  0  0  0  0  0  0  0  0  0  0  0  0  0  0  0  0  0  0  0  0  0  0  0  0  0  0  0  0  0  0  0  0  0  0  0  0  0  0  0  
29  39  40  41  40  41  42  43  40  41  40  41  37  38  1  1  1  1  1  1  1  1  1  1  1  1  1  1  1  1  1  1  1  1  1  1  1  1  1  1  1  1  1  1  20  20  1  1  0  0  0  0  0  0  0  0  0  0  0  0  0  0  0  0  0  0  0  0  0  0  0  0  0  0  0  0  0  0  0  0  0  0  0  0  0  0  0  0  0  0  0  0  0  0  0  0  0  0  0  0  0  0  0  0  0  0  0  0  0  0  0  0  0  0  0  0  0  0  0  0  0  0  0  0  0  0  0  0  
1  1  1  1  1  1  1  1  1  1  1  1  1  1  20  20  20  20  20  20  20  20  20  20  20  20  20  20  20  20  20  20  20  20  20  20  20  20  20  20  20  20  20  20  44  1  1  1  0  0  0  0  0  0  0  0  0  0  0  0  0  0  0  0  0  0  0  0  0  0  0  0  0  0  0  0  0  0  0  0  0  0  0  0  0  0  0  0  0  0  0  0  0  0  0  0  0  0  0  0  0  0  0  0  0  0  0  0  0  0  0  0  0  0  0  0  0  0  0  0  0  0  0  0  0  0  0  0  
10  11  10  11  10  11  10  11  10  11  10  11  10  11  10  11  10  11  12  16  17  18  12  16  17  18  12  16  17  18  12  16  17  18  12  16  17  18  12  16  17  45  46  47  20  20  1  1  0  0  0  0  0  0  0  0  0  0  0  0  0  0  0  0  0  0  0  0  0  0  0  0  0  0  0  0  0  0  0  0  0  0  0  0  0  0  0  0  0  0  0  0  0  0  0  0  0  0  0  0  0  0  0  0  0  0  0  0  0  0  0  0  0  0  0  0  0  0  0  0  0  0  0  0  0  0  0  0  
6  7  6  7  6  7  6  7  6  7  6  7  6  7  6  7  6  7  0  0  48  38  0  0  48  38  0  0  48  38  0  0  48  38  0  0  48  38  0  0  48  38  47  20  20  20  1  1  0  0  0  0  0  0  0  0  0  0  0  0  0  0  0  0  0  0  0  0  0  0  0  0  0  0  0  0  0  0  0  0  0  0  0  0  0  0  0  0  0  0  0  0  0  0  0  0  0  0  0  0  0  0  0  0  0  0  0  0  0  0  0  0  0  0  0  0  0  0  0  0  0  0  0  0  0  0  0  0  
0  0  0  0  0  0  0  0  0  0  0  0  0  0  0  0  0  0  0  0  0  0  0  0  0  0  0  0  0  0  0  0  0  0  0  0  0  0  0  0  0  0  0  0  0  0  0  0  0  0  0  0  0  0  0  0  0  0  0  0  0  0  0  0  0  0  0  0  0  0  0  0  0  0  0  0  0  0  0  0  0  0  0  0  0  0  0  0  0  0  0  0  0  0  0  0  0  0  0  0  0  0  0  0  0  0  0  0  0  0  0  0  0  0  0  0  0  0  0  0  0  0  0  0  0  0  0  0  
1  1  6  7  6  7  6  7  6  7  6  7  6  7  6  7  20  20  0  0  4  5  0  0  4  5  0  0  4  5  0  0  4  5  0  0  4  5  0  0  20  20  49  20  20  20  1  1  1  1  4  5  50  51  4  5  20  20  4  5  50  51  4  5  52  53  20  20  20  20  54  55  20  20  4  5  50  51  4  5  20  20  4  5  20  20  4  5  20  20  4  5  50  51  1  1  0  0  0  0  0  0  0  0  0  0  0  0  0  0  0  0  0  0  0  0  0  0  0  0  0  0  0  0  0  0  0  0  
1  56  57  16  17  18  12  16  17  18  12  16  17  18  12  13  52  53  0  0  37  38  0  0  37  38  0  0  37  38  0  0  37  38  0  0  37  38  0  0  58  47  59  53  60  61  1  1  1  1  9  5  20  20  9  5  62  63  9  5  20  20  9  5  64  65  20  20  20  20  20  20  62  63  9  5  64  66  9  5  20  20  9  5  20  20  37  38  62  63  9  5  67  30  1  1  0  0  0  0  0  0  0  0  0  0  0  0  0  0  0  0  0  0  0  0  0  0  0  0  0  0  0  0  0  0  0  0  
1  1  0  0  4  5  0  0  4  5  0  0  4  5  0  0  1  1  1  1  1  1  1  1  1  1  1  1  1  1  1  1  1  1  1  1  1  1  1  1  1  1  1  1  1  1  1  1  1  1  9  5  20  20  9  5  50  51  9  5  20  20  9  5  54  55  68  20  20  20  20  20  50  51  9  5  54  55  9  5  20  20  9  5  20  20  69  70  50  51  9  5  52  53  1  1  0  0  0  0  0  0  0  0  0  0  0  0  0  0  0  0  0  0  0  0  0  0  0  0  0  0  0  0  0  0  0  0  
1  1  40  40  9  5  40  40  9  5  40  40  9  5  0  0  20  20  12  16  17  18  12  16  17  18  12  71  17  18  12  72  17  18  12  16  17  18  12  13  4  5  20  20  20  20  64  66  0  30  9  5  60  61  37  38  60  61  37  38  60  61  37  38  20  20  20  20  62  63  60  61  20  20  9  5  67  30  37  38  60  61  37  38  62  63  4  5  60  61  37  38  52  53  1  1  0  0  0  0  0  0  0  0  0  0  0  0  0  0  0  0  0  0  0  0  0  0  0  0  0  0  0  0  0  0  0  0  
1  1  40  40  9  5  40  40  9  5  40  40  37  38  1  1  20  20  0  0  4  5  0  0  4  5  0  0  4  5  0  0  4  5  0  0  4  5  0  0  9  5  20  20  20  20  54  55  0  34  9  5  1  1  1  1  1  1  1  1  1  1  1  1  20  20  20  20  50  51  1  1  20  20  9  5  52  53  1  1  1  1  1  1  50  51  9  5  1  1  1  1  1  1  1  1  0  0  0  0  0  0  0  0  0  0  0  0  0  0  0  0  0  0  0  0  0  0  0  0  0  0  0  0  0  0  0  0  
1  1  40  40  9  5  40  40  9  5  73  74  1  1  20  20  67  30  0  0  9  5  0  0  9  5  0  0  9  5  0  0  9  5  40  40  9  5  40  40  9  5  20  20  52  53  60  61  0  39  37  38  64  66  75  18  12  16  17  18  12  16  17  45  19  20  20  20  20  20  75  45  76  30  77  15  12  16  17  18  12  13  4  5  52  53  77  15  12  16  17  18  12  13  1  1  0  0  0  0  0  0  0  0  0  0  0  0  0  0  0  0  0  0  0  0  0  0  0  0  0  0  0  0  0  0  0  0  
1  1  40  40  9  5  40  40  37  38  78  20  20  20  20  20  52  53  0  0  9  5  0  0  9  5  0  0  9  5  0  0  9  5  40  40  9  5  40  40  9  5  20  20  0  1  1  1  1  1  1  1  54  55  4  5  0  0  4  5  0  0  4  5  20  20  20  20  20  20  4  5  52  53  4  5  0  0  4  5  0  0  9  5  1  1  4  5  0  0  4  5  0  0  1  1  0  0  0  0  0  0  0  0  0  0  0  0  0  0  0  0  0  0  0  0  0  0  0  0  0  0  0  0  0  0  0  0  
1  1  40  41  37  38  40  41  0  1  59  53  60  61  60  61  52  53  0  0  37  38  0  0  37  38  0  0  37  38  0  0  9  5  40  40  9  5  40  40  9  5  1  1  1  1  1  1  1  1  14  79  62  63  9  5  20  20  9  5  20  20  37  38  52  53  62  63  60  61  37  38  80  81  37  38  52  53  37  38  60  61  37  38  60  61  37  38  60  61  37  38  60  61  1  1  0  0  0  0  0  0  0  0  0  0  0  0  0  0  0  0  0  0  0  0  0  0  0  0  0  0  0  0  0  0  0  0  
1  1  1  1  1  1  1  1  1  1  1  1  1  1  1  1  1  1  1  1  1  1  1  1  1  1  1  1  1  1  1  1  9  5  40  40  9  5  40  40  9  5  1  1  1  1  1  1  1  1  4  5  50  51  37  38  20  20  37  38  20  20  1  1  1  1  50  51  1  1  1  1  82  83  1  1  1  1  1  1  1  1  1  1  1  1  1  1  1  1  1  1  1  1  1  1  0  0  0  0  0  0  0  0  0  0  0  0  0  0  0  0  0  0  0  0  0  0  0  0  0  0  0  0  0  0  0  0  
1  1  10  11  10  11  10  11  10  11  10  11  10  11  10  11  10  11  10  11  10  11  10  11  10  11  10  11  10  11  1  1  37  38  40  41  37  38  40  41  37  38  1  1  1  1  1  1  1  1  9  5  58  47  1  1  64  66  1  56  57  16  17  18  12  13  0  0  12  16  17  18  0  0  75  18  12  16  17  18  12  16  17  18  12  16  17  18  12  16  17  18  12  13  1  1  0  0  0  0  0  0  0  0  0  0  0  0  0  0  0  0  0  0  0  0  0  0  0  0  0  0  0  0  0  0  0  0  
1  1  6  7  6  7  6  7  6  7  6  7  6  7  6  7  6  7  6  7  6  7  6  7  6  7  6  7  6  7  1  1  1  1  1  1  1  1  1  1  1  1  1  1  1  1  1  1  1  1  37  38  47  20  14  84  85  55  14  86  0  0  48  38  0  0  0  0  0  0  48  38  0  0  48  38  0  0  48  38  0  0  48  38  0  0  48  38  0  0  48  38  0  0  1  1  0  0  0  0  0  0  0  0  0  0  0  0  0  0  0  0  0  0  0  0  0  0  0  0  0  0  0  0  0  0  0  0  
0  0  0  0  0  0  0  0  0  0  0  0  0  0  0  0  0  0  0  0  0  0  0  0  0  0  0  0  0  0  0  0  0  0  0  0  0  0  0  0  0  0  0  0  0  0  0  0  0  0  0  0  0  0  0  0  0  0  0  0  0  0  0  0  0  0  0  0  0  0  0  0  0  0  0  0  0  0  0  0  0  0  0  0  0  0  0  0  0  0  0  0  0  0  0  0  0  0  0  0  0  0  0  0  0  0  0  0  0  0  0  0  0  0  0  0  0  0  0  0  0  0  0  0  0  0  0  0  
0  0  0  0  0  0  0  0  0  0  0  0  0  0  0  0  0  0  0  0  0  0  0  0  0  0  0  0  0  0  0  0  0  0  0  0  0  0  0  0  0  0  0  0  0  0  0  0  1  1  4  5  47  20  4  5  20  20  4  5  20  20  4  5  20  20  4  5  20  20  20  20  20  20  4  5  50  51  4  5  20  20  4  5  20  20  4  5  20  20  4  5  20  20  4  5  1  20  50  51  54  55  4  5  20  20  54  55  50  51  20  20  4  5  20  20  50  51  4  5  20  20  20  20  50  51  1  1  
0  0  0  0  0  0  0  0  0  0  0  0  0  0  0  0  0  0  0  0  0  0  0  0  0  0  0  0  0  0  0  0  0  0  0  0  0  0  0  0  0  0  0  0  0  0  0  0  1  1  37  87  20  20  9  5  20  20  9  5  67  30  9  5  20  20  37  38  20  20  20  20  62  63  9  5  20  20  9  5  20  20  9  5  20  20  9  5  20  20  9  5  20  20  9  5  0  30  64  65  20  20  9  5  67  30  62  63  20  20  20  20  9  5  62  63  20  20  9  5  67  30  62  63  20  20  1  1  
0  0  0  0  0  0  0  0  0  0  0  0  0  0  0  0  0  0  0  0  0  0  0  0  0  0  0  0  0  0  0  0  0  0  0  0  0  0  0  0  0  0  0  0  0  0  0  0  1  1  1  1  20  20  9  5  20  20  9  5  52  53  9  5  20  20  1  1  20  20  20  20  50  51  9  5  20  20  9  5  20  20  9  5  20  20  9  5  20  20  9  5  20  20  9  5  0  34  54  55  68  20  9  5  52  53  50  51  20  20  20  20  9  5  50  51  20  20  9  5  52  53  50  51  20  20  1  1  
0  0  0  0  0  0  0  0  0  0  0  0  0  0  0  0  0  0  0  0  0  0  0  0  0  0  0  0  0  0  0  0  0  0  0  0  0  0  0  0  0  0  0  0  0  0  0  0  1  1  48  38  60  61  37  38  60  61  37  38  52  53  37  38  60  61  4  5  60  61  52  53  52  53  37  38  60  61  37  38  60  61  37  38  52  53  37  38  52  53  37  38  60  61  37  38  0  39  20  20  62  63  37  38  52  53  20  20  60  61  60  61  37  38  64  65  20  20  37  38  52  53  60  61  20  20  1  1  
0  0  0  0  0  0  0  0  0  0  0  0  0  0  0  0  0  0  0  0  0  0  0  0  0  0  0  0  0  0  0  0  0  0  0  0  0  0  0  0  0  0  0  0  0  0  0  0  1  1  1  1  1  1  1  1  1  1  1  1  1  1  1  1  1  1  37  5  1  1  1  1  1  1  1  1  1  1  1  1  1  1  1  1  1  1  1  1  1  1  1  1  1  1  1  1  1  1  20  20  50  51  1  1  1  1  20  20  1  1  1  1  1  1  54  55  68  20  88  89  1  1  1  1  20  20  1  1  
0  0  0  0  0  0  0  0  0  0  0  0  0  0  0  0  0  0  0  0  0  0  0  0  0  0  0  0  0  0  0  0  0  0  0  0  0  0  0  0  0  0  0  0  0  0  0  0  1  1  4  5  12  16  17  18  12  16  17  18  12  16  17  18  12  16  17  18  12  16  17  18  12  16  17  18  12  16  17  18  12  16  17  18  12  16  17  18  12  16  17  18  12  13  1  1  1  20  20  20  52  53  4  5  1  1  20  20  20  20  1  1  1  20  60  61  67  30  1  1  64  66  67  30  20  20  1  1  
0  0  0  0  0  0  0  0  0  0  0  0  0  0  0  0  0  0  0  0  0  0  0  0  0  0  0  0  0  0  0  0  0  0  0  0  0  0  0  0  0  0  0  0  0  0  0  0  1  1  9  5  0  0  4  5  0  0  4  5  0  0  4  5  0  0  4  5  0  0  4  5  0  0  4  5  0  0  4  5  0  0  4  5  0  0  4  5  0  0  4  5  0  0  1  1  1  20  20  20  1  1  9  5  1  1  20  20  20  20  1  1  1  20  1  1  52  53  1  1  54  55  52  53  90  1  1  1  
0  0  0  0  0  0  0  0  0  0  0  0  0  0  0  0  0  0  0  0  0  0  0  0  0  0  0  0  0  0  0  0  0  0  0  0  0  0  0  0  0  0  0  0  0  0  0  0  1  1  9  5  62  63  9  5  62  63  9  5  62  63  9  5  62  63  9  5  62  63  9  5  62  63  9  5  62  63  9  5  62  63  9  5  62  63  9  5  62  63  9  5  62  63  1  1  1  20  62  63  64  66  9  5  1  1  20  20  62  63  1  1  1  20  20  20  52  53  1  1  20  20  58  47  91  5  1  1  
0  0  0  0  0  0  0  0  0  0  0  0  0  0  0  0  0  0  0  0  0  0  0  0  0  0  0  0  0  0  0  0  0  0  0  0  0  0  0  0  0  0  0  0  0  0  0  0  1  1  9  5  50  51  9  5  50  51  9  5  50  51  9  5  50  51  9  5  50  51  9  5  50  51  9  5  50  51  9  5  50  51  9  5  50  51  9  5  50  51  9  5  50  51  1  1  1  20  50  51  54  55  9  5  1  1  20  20  50  51  1  1  1  20  20  20  1  1  1  1  20  20  47  20  9  5  1  1  
0  0  0  0  0  0  0  0  0  0  0  0  0  0  0  0  0  0  0  0  0  0  0  0  0  0  0  0  0  0  0  0  0  0  0  0  0  0  0  0  0  0  0  0  0  0  0  0  1  1  9  5  64  66  9  5  20  20  9  5  64  66  9  5  64  66  9  5  67  30  9  5  20  20  9  5  64  66  9  5  20  20  9  5  64  66  9  5  20  20  9  5  64  66  1  1  1  20  67  30  20  20  9  5  1  1  20  20  20  20  1  1  1  20  20  20  20  20  20  20  58  47  20  20  9  5  1  1  
0  0  0  0  0  0  0  0  0  0  0  0  0  0  0  0  0  0  0  0  0  0  0  0  0  0  0  0  0  0  0  0  0  0  0  0  0  0  0  0  0  0  0  0  0  0  0  0  1  1  37  38  92  55  37  38  20  20  37  38  92  55  37  38  92  55  37  38  52  53  37  38  20  20  37  38  92  55  37  38  20  20  37  38  92  55  37  38  20  20  37  38  92  55  1  1  1  20  52  53  20  20  37  38  1  1  20  20  20  20  1  1  1  20  20  20  20  20  20  20  47  20  20  20  37  38  1  1  
0  0  0  0  0  0  0  0  0  0  0  0  0  0  0  0  0  0  0  0  0  0  0  0  0  0  0  0  0  0  0  0  0  0  0  0  0  0  0  0  0  0  0  0  0  0  0  0  0  0  0  0  0  0  0  0  0  0  0  0  0  0  0  0  0  0  0  0  0  0  0  0  0  0  0  0  0  0  0  0  0  0  0  0  0  0  0  0  0  0  0  0  0  0  0  0  0  0  0  0  0  0  0  0  0  0  0  0  0  0  0  0  0  0  0  0  0  0  0  0  0  0  0  0  0  0  0  0  
0  0  0  0  0  0  0  0  0  0  0  0  0  0  0  0  0  0  0  0  0  0  0  0  0  0  0  0  0  0  0  0  0  0  0  0  0  0  0  0  0  0  0  0  0  0  0  0  0  0  0  0  0  0  0  0  0  0  0  0  0  0  0  0  0  0  0  0  0  0  0  0  0  0  0  0  0  0  0  0  0  0  0  0  0  0  0  0  0  0  0  0  0  0  0  0  0  0  0  0  0  0  0  0  0  0  0  0  0  0  0  0  1  20  4  5  20  20  20  20  47  20  52  53  4  5  1  1  
0  0  0  0  0  0  0  0  0  0  0  0  0  0  0  0  0  0  0  0  0  0  0  0  0  0  0  0  0  0  0  0  0  0  0  0  0  0  0  0  0  0  0  0  0  0  0  0  0  0  0  0  0  0  0  0  0  0  0  0  0  0  0  0  0  0  0  0  0  0  0  0  0  0  0  0  0  0  0  0  0  0  0  0  0  0  0  0  0  0  0  0  0  0  0  0  0  0  0  0  0  0  0  0  0  0  0  0  0  0  0  0  1  20  9  5  20  20  58  47  20  20  64  66  9  5  1  1  
0  0  0  0  0  0  0  0  0  0  0  0  0  0  0  0  0  0  0  0  0  0  0  0  0  0  0  0  0  0  0  0  0  0  0  0  0  0  0  0  0  0  0  0  0  0  0  0  0  0  0  0  0  0  0  0  0  0  0  0  0  0  0  0  0  0  0  0  0  0  0  0  0  0  0  0  0  0  0  0  0  0  0  0  0  0  0  0  0  0  0  0  0  0  0  0  0  0  0  0  0  0  0  0  0  0  0  0  0  0  0  0  1  20  9  5  20  20  49  20  20  20  54  55  9  5  1  1  
0  0  0  0  0  0  0  0  0  0  0  0  0  0  0  0  0  0  0  0  0  0  0  0  0  0  0  0  0  0  0  0  0  0  0  0  0  0  0  0  0  0  0  0  0  0  0  0  0  0  0  0  0  0  0  0  0  0  0  0  0  0  0  0  0  0  0  0  0  0  0  0  0  0  0  0  0  0  0  0  0  0  0  0  0  0  0  0  0  0  0  0  0  0  0  0  0  0  0  0  0  0  0  0  0  0  0  0  0  0  0  0  1  1  37  38  58  47  59  53  60  61  20  20  9  5  1  1  
0  0  0  0  0  0  0  0  0  0  0  0  0  0  0  0  0  0  0  0  0  0  0  0  0  0  0  0  0  0  0  0  0  0  0  0  0  0  0  0  0  0  0  0  0  0  0  0  0  0  0  0  0  0  0  0  0  0  0  0  0  0  0  0  0  0  0  0  0  0  0  0  0  0  0  0  0  0  0  0  0  0  0  0  0  0  0  0  0  0  0  0  0  0  0  0  0  0  0  0  0  0  0  0  0  0  0  0  0  0  0  0  1  1  1  1  1  1  1  1  1  1  20  20  9  5  0  1  
0  0  0  0  0  0  0  0  0  0  0  0  0  0  0  0  0  0  0  0  0  0  0  0  0  0  0  0  0  0  0  0  0  0  0  0  0  0  0  0  0  0  0  0  0  0  0  0  0  0  0  0  0  0  0  0  0  0  0  0  0  0  0  0  0  0  0  0  0  0  0  0  0  0  0  0  0  0  0  0  0  0  0  0  0  0  0  0  0  0  0  0  0  0  0  0  0  0  0  0  0  0  0  0  0  0  0  0  0  0  0  0  1  1  4  5  64  65  20  20  20  20  20  20  37  38  0  1  
0  0  0  0  0  0  0  0  0  0  0  0  0  0  0  0  0  0  0  0  0  0  0  0  0  0  0  0  0  0  0  0  0  0  0  0  0  0  0  0  0  0  0  0  0  0  0  0  0  0  0  0  0  0  0  0  0  0  0  0  0  0  0  0  0  0  0  0  0  0  0  0  0  0  0  0  0  0  0  0  0  0  0  0  0  0  0  0  0  0  0  0  0  0  0  0  0  0  0  0  0  0  0  0  0  0  0  0  0  0  0  0  1  1  9  5  54  55  68  20  20  20  44  1  1  1  1  1  
0  0  0  0  0  0  0  0  0  0  0  0  0  0  0  0  0  0  0  0  0  0  0  0  0  0  0  0  0  0  0  0  0  0  0  0  0  0  0  0  0  0  0  0  0  0  0  0  0  0  0  0  0  0  0  0  0  0  0  0  0  0  0  0  0  0  0  0  0  0  0  0  0  0  0  0  0  0  0  0  0  0  0  0  0  0  0  0  0  0  0  0  0  0  0  0  0  0  0  0  0  0  0  0  0  0  0  0  0  0  0  0  93  30  9  5  20  20  20  20  58  47  20  20  67  30  1  1  
0  0  0  0  0  0  0  0  0  0  0  0  0  0  0  0  0  0  0  0  0  0  0  0  0  0  0  0  0  0  0  0  0  0  0  0  0  0  0  0  0  0  0  0  0  0  0  0  0  0  0  0  0  0  0  0  0  0  0  0  0  0  0  0  0  0  0  0  0  0  0  0  0  0  0  0  0  0  0  0  0  0  0  0  0  0  0  0  0  0  0  0  0  0  0  0  0  0  0  0  0  0  0  0  0  0  0  0  0  0  0  0  94  34  9  5  20  20  20  20  47  20  20  20  52  53  1  1  
0  0  0  0  0  0  0  0  0  0  0  0  0  0  0  0  0  0  0  0  0  0  0  0  0  0  0  0  0  0  0  0  0  0  0  0  0  0  0  0  0  0  0  0  0  0  0  0  0  0  0  0  0  0  0  0  0  0  0  0  0  0  0  0  0  0  0  0  0  0  0  0  0  0  0  0  0  0  0  0  0  0  0  0  0  0  0  0  0  0  0  0  0  0  0  0  0  0  0  0  0  0  0  0  0  0  0  0  0  0  0  0  95  39  37  38  52  53  58  47  60  61  60  61  52  53  1  1  
0  0  0  0  0  0  0  0  0  0  0  0  0  0  0  0  0  0  0  0  0  0  0  0  0  0  0  0  0  0  0  0  0  0  0  0  0  0  0  0  0  0  0  0  0  0  0  0  0  0  0  0  0  0  0  0  0  0  0  0  0  0  0  0  0  0  0  0  0  0  0  0  0  0  0  0  0  0  0  0  0  0  0  0  0  0  0  0  0  0  0  0  0  0  0  0  0  0  0  0  0  0  0  0  0  0  0  0  0  0  0  0  1  1  1  1  1  1  1  1  1  1  1  1  1  1  1  1  
0  0  0  0  0  0  0  0  0  0  0  0  0  0  0  0  0  0  0  0  0  0  0  0  0  0  0  0  0  0  0  0  0  0  0  0  0  0  0  0  0  0  0  0  0  0  0  0  0  0  0  0  0  0  0  0  0  0  0  0  0  0  0  0  0  0  0  0  0  0  0  0  0  0  0  0  0  0  0  0  0  0  0  0  0  0  0  0  0  0  0  0  0  0  0  0  0  0  0  0  0  0  0  0  0  0  0  0  0  0  0  0  0  0  0  0  0  0  0  0  0  0  0  0  0  0  0  0  
