0		0		0		4096		4096		
1		0		0		2048		2048		
2		2048		0		2048		2048		
3		0		2048		2048		2048		
31		0		2048		1024		1024		
311		0		2048		512		512		
312		512		2048		512		512		
313		0		2560		512		512		
3131		0		2560		256		256		575		584		16		12		8		4		0		
3132		256		2560		256		256		585		24		612		705		
3133		0		2816		256		256		130		92		85		77		56		
3134		256		2816		256		256		578		577		56		
314		512		2560		512		512		
3141		512		2560		256		256		24		613		614		592		706		707		591		
3142		768		2560		256		256		24		609		593		615		616		708		709		
3143		512		2816		256		256		588		94		576		
3144		768		2816		256		256		589		590		94		587		
32		1024		2048		1024		1024		
321		1024		2048		512		512		
322		1536		2048		512		512		
323		1024		2560		512		512		
3231		1024		2560		256		256		24		617		618		711		710		
3232		1280		2560		256		256		24		54		22		20		18		619		620		712		713		14		10		6		2		
3233		1024		2816		256		256		94		
3234		1280		2816		256		256		94		549		86		545		79		548		75				73		563		70		
324		1536		2560		512		512		
3241		1536		2560		256		256		
3242		1792		2560		256		256		
3243		1536		2816		256		256		579		94		86		79		
3244		1792		2816		256		256		631		688		
33		0		3072		1024		1024		
331		0		3072		512		512		
3311		0		3072		256		256		285		268		198		185		565		574		172		166		622		134		704		
3312		256		3072		256		256		198		565		574		187		543		621		623		703		702		544		168		136		
3313		0		3328		256		256		
3314		256		3328		256		256		
332		512		3072		512		512		
3321		512		3072		256		256		198		586		625		624		701		700		588		
3322		768		3072		256		256		287		270		198		627		626		699		698		589		590		
3323		512		3328		256		256		
3324		768		3328		256		256		
333		0		3584		512		512		
334		512		3584		512		512		
34		1024		3072		1024		1024		
341		1024		3072		512		512		
3411		1024		3072		256		256		287		629		628		696		697		
3412		1280		3072		256		256		287		272		230		188		630		566		174		695		573		
3413		1024		3328		256		256		
3414		1280		3328		256		256		
342		1536		3072		512		512		
3421		1536		3072		256		256		287		551		272		550		280		230		188		174		641		694		579		138		
3422		1792		3072		256		256		282		238		608		640		693		138		
3423		1536		3328		256		256		427		408		394		330		326		318		314		542		642		692		309		552		
3424		1792		3328		256		256		330		600		643		691		644		690		
343		1024		3584		512		512		
344		1536		3584		512		512		
3441		1536		3584		256		256		469		457		441		
3442		1792		3584		256		256		
3443		1536		3840		256		256		
3444		1792		3840		256		256		
4		2048		2048		2048		2048		
41		2048		2048		1024		1024		
411		2048		2048		512		512		
412		2560		2048		512		512		
413		2048		2560		512		512		
4131		2048		2560		256		256		
4132		2304		2560		256		256		
4133		2048		2816		256		256		632		687		
4134		2304		2816		256		256		633		684		
414		2560		2560		512		512		
4141		2560		2560		256		256		
4142		2816		2560		256		256		
4143		2560		2816		256		256		599		538		567		572		635		634		677		680		
4144		2816		2816		256		256		132		597		128		90		636		676		83		
42		3072		2048		1024		1024		
43		2048		3072		1024		1024		
431		2048		3072		512		512		
4311		2048		3072		256		256		238		607		242		639		606		686		150		594		
4312		2304		3072		256		256		246		598		638		681		152		595		
4313		2048		3328		256		256		330		348		645		689		322		604		646		685		
4314		2304		3328		256		256		348		610		605		647		648		683		682		
432		2560		3072		512		512		
4321		2560		3072		256		256		246		181		152		
4322		2816		3072		256		256		307		283		246		196		637		675		183		170		158		
4323		2560		3328		256		256		348		650		649		678		679		
4324		2816		3328		256		256		429		410		396		348		651		652		674		673		
433		2048		3584		512		512		
434		2560		3584		512		512		
4341		2560		3584		256		256		
4342		2816		3584		256		256		471		459		443		
4343		2560		3840		256		256		
4344		2816		3840		256		256		
44		3072		3072		1024		1024		
441		3072		3072		512		512		
4411		3072		3072		256		256		
4412		3328		3072		256		256		
4413		3072		3328		256		256		429		410		413		396		348		378		596		580		653		672		311		
4414		3328		3328		256		256		432		434		415		417		399		401		378		382		603		654		655		671		670		
442		3584		3072		512		512		
4421		3584		3072		256		256		
4422		3840		3072		256		256		
4423		3584		3328		256		256		434		437		602		417		420		422		401		404		568		571		382		537		583		656		657		669		668		
4424		3840		3328		256		256				439		541		424		406		537		392		328		324		316		659		658		666		667		312		
443		3072		3584		512		512		
4431		3072		3584		256		256		471		459		443		
4432		3328		3584		256		256		474		476		462		464		446		448		
4433		3072		3840		256		256		
4434		3328		3840		256		256		
444		3584		3584		512		512		
4441		3584		3584		256		256		490		559		487				484				582		481		476		464		448		451		
4442		3840		3584		256		256		492		601		488		485		662		665		557		482		556		479				467				455		
4443		3584		3840		256		256		521		562		581		661		664		508		505		494		
4444		3840		3840		256		256		521		611		519				517				515		660		663		564		510		570		507		494		569		504		
