91  
52  128
0  0  0  0  0  0  0  0  0  0  0  0  0  0  0  0  0  0  0  0  0  0  0  0  0  0  0  0  0  0  0  0  0  0  0  0  0  0  0  0  0  0  0  0  0  0  0  0  0  0  0  0  0  0  0  0  0  0  0  0  0  0  0  0  0  0  0  0  0  0  0  0  0  0  0  0  0  0  0  0  0  0  0  0  0  0  0  0  0  0  0  0  0  0  0  0  0  0  0  0  0  0  0  0  0  0  0  0  0  0  0  0  0  0  0  0  0  0  0  0  0  0  0  0  0  0  0  0  
0  0  0  0  0  0  0  0  0  0  0  0  0  0  0  0  0  0  0  0  0  0  0  0  0  0  0  0  0  0  0  0  0  0  0  0  0  0  0  0  0  0  0  0  0  0  0  0  0  0  0  0  0  0  0  0  0  0  0  0  0  0  0  0  0  0  0  0  0  0  0  0  0  0  0  0  0  0  0  0  0  0  0  0  0  0  0  0  0  0  0  0  0  0  0  0  0  0  0  0  0  0  0  0  0  0  0  0  0  0  0  0  0  0  0  0  0  0  0  0  0  0  0  0  0  0  0  0  
0  0  0  0  0  0  0  0  0  0  0  0  0  0  0  0  0  0  0  0  0  0  0  0  0  0  0  0  0  0  0  0  0  0  0  0  0  0  0  0  0  0  0  0  0  0  0  0  0  0  0  0  0  0  0  0  0  0  0  0  0  0  0  0  0  0  0  0  0  0  0  0  0  0  0  0  0  0  0  0  0  0  0  0  0  0  0  0  0  0  0  0  0  0  0  0  0  0  0  0  0  0  0  0  0  0  0  0  0  0  0  0  0  0  0  0  0  0  0  0  0  0  0  0  0  0  0  0  
1  1  0  0  0  0  2  3  0  0  0  0  4  5  6  7  6  7  6  7  6  7  6  7  6  7  6  7  6  7  6  7  6  7  6  7  6  7  6  7  6  7  6  7  6  7  1  1  0  0  0  0  0  0  0  0  0  0  0  0  0  0  0  0  0  0  0  0  0  0  0  0  0  0  0  0  0  0  0  0  0  0  0  0  0  0  0  0  0  0  0  0  0  0  0  0  0  0  0  0  0  0  0  0  0  0  0  0  0  0  0  0  0  0  0  0  0  0  0  0  0  0  0  0  0  0  0  0  
1  1  0  0  0  0  8  8  0  0  0  0  9  5  10  11  10  11  12  13  14  15  12  16  17  18  12  16  17  18  12  16  17  18  12  16  17  18  12  16  17  18  12  16  19  20  1  1  0  0  0  0  0  0  0  0  0  0  0  0  0  0  0  0  0  0  0  0  0  0  0  0  0  0  0  0  0  0  0  0  0  0  0  0  0  0  0  0  0  0  0  0  0  0  0  0  0  0  0  0  0  0  0  0  0  0  0  0  0  0  0  0  0  0  0  0  0  0  0  0  0  0  0  0  0  0  0  0  
1  1  0  0  21  22  8  8  21  22  0  0  9  5  6  7  6  7  0  0  4  5  0  0  4  5  0  0  4  5  0  0  4  5  0  0  4  5  0  0  4  5  0  0  20  20  1  1  0  0  0  0  0  0  0  0  0  0  0  0  0  0  0  0  0  0  0  0  0  0  0  0  0  0  0  0  0  0  0  0  0  0  0  0  0  0  0  0  0  0  0  0  0  0  0  0  0  0  0  0  0  0  0  0  0  0  0  0  0  0  0  0  0  0  0  0  0  0  0  0  0  0  0  0  0  0  0  0  
1  1  0  0  23  24  8  8  23  24  0  0  9  5  20  20  20  20  25  26  9  5  25  26  9  5  25  26  9  5  25  26  9  5  25  26  9  5  25  26  9  5  25  26  20  20  1  1  0  0  0  0  0  0  0  0  0  0  0  0  0  0  0  0  0  0  0  0  0  0  0  0  0  0  0  0  0  0  0  0  0  0  0  0  0  0  0  0  0  0  0  0  0  0  0  0  0  0  0  0  0  0  0  0  0  0  0  0  0  0  0  0  0  0  0  0  0  0  0  0  0  0  0  0  0  0  0  0  
1  1  21  22  23  24  8  8  23  24  21  22  9  5  20  20  20  20  27  28  9  5  27  28  9  5  27  28  9  5  27  28  9  5  27  28  9  5  27  28  9  5  27  28  20  20  1  1  0  0  0  0  0  0  0  0  0  0  0  0  0  0  0  0  0  0  0  0  0  0  0  0  0  0  0  0  0  0  0  0  0  0  0  0  0  0  0  0  0  0  0  0  0  0  0  0  0  0  0  0  0  0  0  0  0  0  0  0  0  0  0  0  0  0  0  0  0  0  0  0  0  0  0  0  0  0  0  0  
0  29  23  24  23  24  30  31  23  24  23  24  9  5  20  20  20  20  32  28  9  5  32  28  9  5  32  28  9  5  32  28  9  5  32  28  9  5  32  28  9  5  32  28  20  20  1  1  0  0  0  0  0  0  0  0  0  0  0  0  0  0  0  0  0  0  0  0  0  0  0  0  0  0  0  0  0  0  0  0  0  0  0  0  0  0  0  0  0  0  0  0  0  0  0  0  0  0  0  0  0  0  0  0  0  0  0  0  0  0  0  0  0  0  0  0  0  0  0  0  0  0  0  0  0  0  0  0  
0  33  23  24  23  24  34  35  23  24  23  24  9  5  20  20  20  20  27  28  36  37  27  28  36  37  27  28  36  37  27  28  36  37  27  28  36  37  27  28  36  37  27  28  20  20  1  1  0  0  0  0  0  0  0  0  0  0  0  0  0  0  0  0  0  0  0  0  0  0  0  0  0  0  0  0  0  0  0  0  0  0  0  0  0  0  0  0  0  0  0  0  0  0  0  0  0  0  0  0  0  0  0  0  0  0  0  0  0  0  0  0  0  0  0  0  0  0  0  0  0  0  0  0  0  0  0  0  
0  38  39  40  39  40  41  42  39  40  39  40  36  37  1  1  1  1  1  1  1  1  1  1  1  1  1  1  1  1  1  1  1  1  1  1  1  1  1  1  1  1  1  1  20  20  1  1  0  0  0  0  0  0  0  0  0  0  0  0  0  0  0  0  0  0  0  0  0  0  0  0  0  0  0  0  0  0  0  0  0  0  0  0  0  0  0  0  0  0  0  0  0  0  0  0  0  0  0  0  0  0  0  0  0  0  0  0  0  0  0  0  0  0  0  0  0  0  0  0  0  0  0  0  0  0  0  0  
1  1  1  1  1  1  1  1  1  1  1  1  1  1  20  20  20  20  20  20  20  20  20  20  20  20  20  20  20  20  20  20  20  20  20  20  20  20  20  20  20  20  20  20  43  1  1  1  0  0  0  0  0  0  0  0  0  0  0  0  0  0  0  0  0  0  0  0  0  0  0  0  0  0  0  0  0  0  0  0  0  0  0  0  0  0  0  0  0  0  0  0  0  0  0  0  0  0  0  0  0  0  0  0  0  0  0  0  0  0  0  0  0  0  0  0  0  0  0  0  0  0  0  0  0  0  0  0  
10  11  10  11  10  11  10  11  10  11  10  11  10  11  10  11  10  11  12  16  17  18  12  16  17  18  12  16  17  18  12  16  17  18  12  16  17  18  12  16  17  44  45  46  20  20  1  1  0  0  0  0  0  0  0  0  0  0  0  0  0  0  0  0  0  0  0  0  0  0  0  0  0  0  0  0  0  0  0  0  0  0  0  0  0  0  0  0  0  0  0  0  0  0  0  0  0  0  0  0  0  0  0  0  0  0  0  0  0  0  0  0  0  0  0  0  0  0  0  0  0  0  0  0  0  0  0  0  
6  7  6  7  6  7  6  7  6  7  6  7  6  7  6  7  6  7  0  0  47  37  0  0  47  37  0  0  47  37  0  0  47  37  0  0  47  37  0  0  47  37  46  20  20  20  1  1  0  0  0  0  0  0  0  0  0  0  0  0  0  0  0  0  0  0  0  0  0  0  0  0  0  0  0  0  0  0  0  0  0  0  0  0  0  0  0  0  0  0  0  0  0  0  0  0  0  0  0  0  0  0  0  0  0  0  0  0  0  0  0  0  0  0  0  0  0  0  0  0  0  0  0  0  0  0  0  0  
0  0  0  0  0  0  0  0  0  0  0  0  0  0  0  0  0  0  0  0  0  0  0  0  0  0  0  0  0  0  0  0  0  0  0  0  0  0  0  0  0  0  0  0  0  0  0  0  0  0  0  0  0  0  0  0  0  0  0  0  0  0  0  0  0  0  0  0  0  0  0  0  0  0  0  0  0  0  0  0  0  0  0  0  0  0  0  0  0  0  0  0  0  0  0  0  0  0  0  0  0  0  0  0  0  0  0  0  0  0  0  0  0  0  0  0  0  0  0  0  0  0  0  0  0  0  0  0  
1  1  6  7  6  7  6  7  6  7  6  7  6  7  6  7  20  20  0  0  4  5  0  0  4  5  0  0  4  5  0  0  4  5  0  0  4  5  0  0  20  20  48  20  20  20  1  1  1  1  4  5  49  50  4  5  20  20  4  5  49  50  4  5  51  52  20  20  20  20  53  54  20  20  4  5  49  50  4  5  20  20  4  5  20  20  4  5  20  20  4  5  49  50  1  1  0  0  0  0  0  0  0  0  0  0  0  0  0  0  0  0  0  0  0  0  0  0  0  0  0  0  0  0  0  0  0  0  
1  55  56  16  17  18  12  16  17  18  12  16  17  18  12  13  51  52  0  0  36  37  0  0  36  37  0  0  36  37  0  0  36  37  0  0  36  37  0  0  57  46  58  52  59  60  1  1  1  1  9  5  20  20  9  5  61  62  9  5  20  20  9  5  63  64  20  20  20  20  20  20  61  62  9  5  63  65  9  5  20  20  9  5  20  20  36  37  61  62  9  5  66  29  1  1  0  0  0  0  0  0  0  0  0  0  0  0  0  0  0  0  0  0  0  0  0  0  0  0  0  0  0  0  0  0  0  0  
1  1  0  0  4  5  0  0  4  5  0  0  4  5  0  0  1  1  1  1  1  1  1  1  1  1  1  1  1  1  1  1  1  1  1  1  1  1  1  1  1  1  1  1  1  1  1  1  1  1  9  5  20  20  9  5  49  50  9  5  20  20  9  5  53  54  67  20  20  20  20  20  49  50  9  5  53  54  9  5  20  20  9  5  20  20  1  1  49  50  9  5  51  52  1  1  0  0  0  0  0  0  0  0  0  0  0  0  0  0  0  0  0  0  0  0  0  0  0  0  0  0  0  0  0  0  0  0  
1  1  39  39  9  5  39  39  9  5  39  39  9  5  0  0  20  20  12  16  17  18  12  16  17  18  12  68  17  18  12  69  17  18  12  16  17  18  12  13  4  5  20  20  20  20  63  65  0  29  9  5  59  60  36  37  59  60  36  37  59  60  36  37  20  20  20  20  61  62  59  60  20  20  9  5  66  29  36  37  59  60  36  37  61  62  4  5  59  60  36  37  51  52  1  1  0  0  0  0  0  0  0  0  0  0  0  0  0  0  0  0  0  0  0  0  0  0  0  0  0  0  0  0  0  0  0  0  
1  1  39  39  9  5  39  39  9  5  39  39  36  37  1  1  20  20  0  0  4  5  0  0  4  5  0  0  4  5  0  0  4  5  0  0  4  5  0  0  9  5  20  20  20  20  53  54  0  33  9  5  1  1  1  1  1  1  1  1  1  1  1  1  20  20  20  20  49  50  1  1  20  20  9  5  51  52  1  1  1  1  1  1  49  50  9  5  1  1  1  1  1  1  1  1  0  0  0  0  0  0  0  0  0  0  0  0  0  0  0  0  0  0  0  0  0  0  0  0  0  0  0  0  0  0  0  0  
1  1  39  39  9  5  39  39  9  5  70  71  1  1  20  20  66  29  0  0  9  5  0  0  9  5  0  0  9  5  0  0  9  5  39  39  9  5  39  39  9  5  20  20  51  52  59  60  0  38  36  37  63  65  72  18  12  16  17  18  12  16  17  44  19  20  20  20  20  20  72  44  73  29  74  15  12  16  17  18  12  13  4  5  51  52  74  15  12  16  17  18  12  13  1  1  0  0  0  0  0  0  0  0  0  0  0  0  0  0  0  0  0  0  0  0  0  0  0  0  0  0  0  0  0  0  0  0  
1  1  39  39  9  5  39  39  36  37  75  20  20  20  20  20  51  52  0  0  9  5  0  0  9  5  0  0  9  5  0  0  9  5  39  39  9  5  39  39  9  5  20  20  1  1  1  1  1  1  1  1  53  54  4  5  0  0  4  5  0  0  4  5  20  20  20  20  20  20  4  5  51  52  4  5  0  0  4  5  0  0  9  5  1  1  4  5  0  0  4  5  0  0  1  1  0  0  0  0  0  0  0  0  0  0  0  0  0  0  0  0  0  0  0  0  0  0  0  0  0  0  0  0  0  0  0  0  
1  1  39  40  36  37  39  40  1  1  58  52  59  60  59  60  51  52  0  0  36  37  0  0  36  37  0  0  36  37  0  0  9  5  39  39  9  5  39  39  9  5  1  1  1  1  1  1  1  1  14  76  61  62  9  5  20  20  9  5  20  20  36  37  51  52  61  62  59  60  36  37  77  78  36  37  51  52  36  37  59  60  36  37  59  60  36  37  59  60  36  37  59  60  1  1  0  0  0  0  0  0  0  0  0  0  0  0  0  0  0  0  0  0  0  0  0  0  0  0  0  0  0  0  0  0  0  0  
1  1  1  1  1  1  1  1  1  1  1  1  1  1  1  1  1  1  1  1  1  1  1  1  1  1  1  1  1  1  1  1  9  5  39  39  9  5  39  39  9  5  1  1  1  1  1  1  1  1  4  5  49  50  36  37  20  20  36  37  20  20  1  1  1  1  49  50  1  1  1  1  79  80  1  1  1  1  1  1  1  1  1  1  1  1  1  1  1  1  1  1  1  1  1  1  0  0  0  0  0  0  0  0  0  0  0  0  0  0  0  0  0  0  0  0  0  0  0  0  0  0  0  0  0  0  0  0  
1  1  10  11  10  11  10  11  10  11  10  11  10  11  10  11  10  11  10  11  10  11  10  11  10  11  10  11  10  11  1  1  36  37  39  40  36  37  39  40  36  37  1  1  1  1  1  1  1  1  9  5  57  46  1  1  63  65  1  55  56  16  17  18  12  13  0  0  12  16  17  18  0  0  72  18  12  16  17  18  12  16  17  18  12  16  17  18  12  16  17  18  12  13  1  1  0  0  0  0  0  0  0  0  0  0  0  0  0  0  0  0  0  0  0  0  0  0  0  0  0  0  0  0  0  0  0  0  
1  1  6  7  6  7  6  7  6  7  6  7  6  7  6  7  6  7  6  7  6  7  6  7  6  7  6  7  6  7  1  1  1  1  1  1  1  1  1  1  1  1  1  1  1  1  1  1  1  1  36  37  46  20  14  81  82  54  14  83  0  0  47  37  0  0  0  0  0  0  47  37  0  0  47  37  0  0  47  37  0  0  47  37  0  0  47  37  0  0  47  37  0  0  1  1  0  0  0  0  0  0  0  0  0  0  0  0  0  0  0  0  0  0  0  0  0  0  0  0  0  0  0  0  0  0  0  0  
0  0  0  0  0  0  0  0  0  0  0  0  0  0  0  0  0  0  0  0  0  0  0  0  0  0  0  0  0  0  0  0  0  0  0  0  0  0  0  0  0  0  0  0  0  0  0  0  0  0  0  0  0  0  0  0  0  0  0  0  0  0  0  0  0  0  0  0  0  0  0  0  0  0  0  0  0  0  0  0  0  0  0  0  0  0  0  0  0  0  0  0  0  0  0  0  0  0  0  0  0  0  0  0  0  0  0  0  0  0  0  0  0  0  0  0  0  0  0  0  0  0  0  0  0  0  0  0  
0  0  0  0  0  0  0  0  0  0  0  0  0  0  0  0  0  0  0  0  0  0  0  0  0  0  0  0  0  0  0  0  0  0  0  0  0  0  0  0  0  0  0  0  0  0  0  0  1  1  4  5  46  20  4  5  20  20  4  5  20  20  4  5  20  20  4  5  20  20  20  20  20  20  4  5  49  50  4  5  20  20  4  5  20  20  4  5  20  20  4  5  20  20  4  5  1  20  49  50  53  54  4  5  20  20  53  54  49  50  20  20  4  5  20  20  49  50  4  5  20  20  20  20  49  50  1  1  
0  0  0  0  0  0  0  0  0  0  0  0  0  0  0  0  0  0  0  0  0  0  0  0  0  0  0  0  0  0  0  0  0  0  0  0  0  0  0  0  0  0  0  0  0  0  0  0  1  1  36  84  20  20  9  5  20  20  9  5  66  29  9  5  20  20  36  37  20  20  20  20  61  62  9  5  20  20  9  5  20  20  9  5  20  20  9  5  20  20  9  5  20  20  9  5  0  29  63  64  20  20  9  5  66  29  61  62  20  20  20  20  9  5  61  62  20  20  9  5  66  29  61  62  20  20  1  1  
0  0  0  0  0  0  0  0  0  0  0  0  0  0  0  0  0  0  0  0  0  0  0  0  0  0  0  0  0  0  0  0  0  0  0  0  0  0  0  0  0  0  0  0  0  0  0  0  1  1  1  1  20  20  9  5  20  20  9  5  51  52  9  5  20  20  1  1  20  20  20  20  49  50  9  5  20  20  9  5  20  20  9  5  20  20  9  5  20  20  9  5  20  20  9  5  0  33  53  54  67  20  9  5  51  52  49  50  20  20  20  20  9  5  49  50  20  20  9  5  51  52  49  50  20  20  1  1  
0  0  0  0  0  0  0  0  0  0  0  0  0  0  0  0  0  0  0  0  0  0  0  0  0  0  0  0  0  0  0  0  0  0  0  0  0  0  0  0  0  0  0  0  0  0  0  0  1  1  47  37  59  60  36  37  59  60  36  37  51  52  36  37  59  60  4  5  59  60  51  52  51  52  36  37  59  60  36  37  59  60  36  37  51  52  36  37  51  52  36  37  59  60  36  37  0  38  20  20  61  62  36  37  51  52  20  20  59  60  59  60  36  37  63  64  20  20  36  37  51  52  59  60  20  20  1  1  
0  0  0  0  0  0  0  0  0  0  0  0  0  0  0  0  0  0  0  0  0  0  0  0  0  0  0  0  0  0  0  0  0  0  0  0  0  0  0  0  0  0  0  0  0  0  0  0  1  1  1  1  1  1  1  1  1  1  1  1  1  1  1  1  1  1  36  5  1  1  1  1  1  1  1  1  1  1  1  1  1  1  1  1  1  1  1  1  1  1  1  1  1  1  1  1  1  1  20  20  49  50  1  1  1  1  20  20  1  1  1  1  1  1  53  54  67  20  1  1  1  1  1  1  20  20  1  1  
0  0  0  0  0  0  0  0  0  0  0  0  0  0  0  0  0  0  0  0  0  0  0  0  0  0  0  0  0  0  0  0  0  0  0  0  0  0  0  0  0  0  0  0  0  0  0  0  1  1  4  5  12  16  17  18  12  16  17  18  12  16  17  18  12  16  17  18  12  16  17  18  12  16  17  18  12  16  17  18  12  16  17  18  12  16  17  18  12  16  17  18  12  13  1  1  1  20  20  20  51  52  4  5  1  1  20  20  20  20  1  1  1  20  59  60  66  29  1  1  63  65  66  29  20  20  1  1  
0  0  0  0  0  0  0  0  0  0  0  0  0  0  0  0  0  0  0  0  0  0  0  0  0  0  0  0  0  0  0  0  0  0  0  0  0  0  0  0  0  0  0  0  0  0  0  0  1  1  9  5  0  0  4  5  0  0  4  5  0  0  4  5  0  0  4  5  0  0  4  5  0  0  4  5  0  0  4  5  0  0  4  5  0  0  4  5  0  0  4  5  0  0  1  1  1  20  20  20  1  1  9  5  1  1  20  20  20  20  1  1  1  20  1  1  51  52  1  1  53  54  51  52  85  1  1  1  
0  0  0  0  0  0  0  0  0  0  0  0  0  0  0  0  0  0  0  0  0  0  0  0  0  0  0  0  0  0  0  0  0  0  0  0  0  0  0  0  0  0  0  0  0  0  0  0  1  1  9  5  61  62  9  5  61  62  9  5  61  62  9  5  61  62  9  5  61  62  9  5  61  62  9  5  61  62  9  5  61  62  9  5  61  62  9  5  61  62  9  5  61  62  1  1  1  20  61  62  63  65  9  5  1  1  20  20  61  62  1  1  1  20  20  20  51  52  1  1  20  20  57  46  86  5  1  1  
0  0  0  0  0  0  0  0  0  0  0  0  0  0  0  0  0  0  0  0  0  0  0  0  0  0  0  0  0  0  0  0  0  0  0  0  0  0  0  0  0  0  0  0  0  0  0  0  1  1  9  5  49  50  9  5  49  50  9  5  49  50  9  5  49  50  9  5  49  50  9  5  49  50  9  5  49  50  9  5  49  50  9  5  49  50  9  5  49  50  9  5  49  50  1  1  1  20  49  50  53  54  9  5  1  1  20  20  49  50  1  1  1  20  20  20  1  1  1  1  20  20  46  20  9  5  1  1  
0  0  0  0  0  0  0  0  0  0  0  0  0  0  0  0  0  0  0  0  0  0  0  0  0  0  0  0  0  0  0  0  0  0  0  0  0  0  0  0  0  0  0  0  0  0  0  0  1  1  9  5  63  65  9  5  20  20  9  5  63  65  9  5  63  65  9  5  66  29  9  5  20  20  9  5  63  65  9  5  20  20  9  5  63  65  9  5  20  20  9  5  63  65  1  1  1  20  66  29  20  20  9  5  1  1  20  20  20  20  1  1  1  20  20  20  20  20  20  20  57  46  20  20  9  5  1  1  
0  0  0  0  0  0  0  0  0  0  0  0  0  0  0  0  0  0  0  0  0  0  0  0  0  0  0  0  0  0  0  0  0  0  0  0  0  0  0  0  0  0  0  0  0  0  0  0  1  1  36  37  87  54  36  37  20  20  36  37  87  54  36  37  87  54  36  37  51  52  36  37  20  20  36  37  87  54  36  37  20  20  36  37  87  54  36  37  20  20  36  37  87  54  1  1  1  20  51  52  20  20  36  37  1  1  20  20  20  20  1  1  1  20  20  20  20  20  20  20  46  20  20  20  36  37  1  1  
0  0  0  0  0  0  0  0  0  0  0  0  0  0  0  0  0  0  0  0  0  0  0  0  0  0  0  0  0  0  0  0  0  0  0  0  0  0  0  0  0  0  0  0  0  0  0  0  0  0  0  0  0  0  0  0  0  0  0  0  0  0  0  0  0  0  0  0  0  0  0  0  0  0  0  0  0  0  0  0  0  0  0  0  0  0  0  0  0  0  0  0  0  0  0  0  0  0  0  0  0  0  0  0  0  0  0  0  0  0  0  0  0  0  0  0  0  0  0  0  0  0  0  0  0  0  0  0  
0  0  0  0  0  0  0  0  0  0  0  0  0  0  0  0  0  0  0  0  0  0  0  0  0  0  0  0  0  0  0  0  0  0  0  0  0  0  0  0  0  0  0  0  0  0  0  0  0  0  0  0  0  0  0  0  0  0  0  0  0  0  0  0  0  0  0  0  0  0  0  0  0  0  0  0  0  0  0  0  0  0  0  0  0  0  0  0  0  0  0  0  0  0  0  0  0  0  0  0  0  0  0  0  0  0  0  0  0  0  0  0  1  20  4  5  20  20  20  20  46  20  51  52  4  5  1  1  
0  0  0  0  0  0  0  0  0  0  0  0  0  0  0  0  0  0  0  0  0  0  0  0  0  0  0  0  0  0  0  0  0  0  0  0  0  0  0  0  0  0  0  0  0  0  0  0  0  0  0  0  0  0  0  0  0  0  0  0  0  0  0  0  0  0  0  0  0  0  0  0  0  0  0  0  0  0  0  0  0  0  0  0  0  0  0  0  0  0  0  0  0  0  0  0  0  0  0  0  0  0  0  0  0  0  0  0  0  0  0  0  1  20  9  5  20  20  57  46  20  20  63  65  9  5  1  1  
0  0  0  0  0  0  0  0  0  0  0  0  0  0  0  0  0  0  0  0  0  0  0  0  0  0  0  0  0  0  0  0  0  0  0  0  0  0  0  0  0  0  0  0  0  0  0  0  0  0  0  0  0  0  0  0  0  0  0  0  0  0  0  0  0  0  0  0  0  0  0  0  0  0  0  0  0  0  0  0  0  0  0  0  0  0  0  0  0  0  0  0  0  0  0  0  0  0  0  0  0  0  0  0  0  0  0  0  0  0  0  0  1  20  9  5  20  20  48  20  20  20  53  54  9  5  1  1  
0  0  0  0  0  0  0  0  0  0  0  0  0  0  0  0  0  0  0  0  0  0  0  0  0  0  0  0  0  0  0  0  0  0  0  0  0  0  0  0  0  0  0  0  0  0  0  0  0  0  0  0  0  0  0  0  0  0  0  0  0  0  0  0  0  0  0  0  0  0  0  0  0  0  0  0  0  0  0  0  0  0  0  0  0  0  0  0  0  0  0  0  0  0  0  0  0  0  0  0  0  0  0  0  0  0  0  0  0  0  0  0  1  1  36  37  57  46  58  52  59  60  20  20  9  5  1  1  
0  0  0  0  0  0  0  0  0  0  0  0  0  0  0  0  0  0  0  0  0  0  0  0  0  0  0  0  0  0  0  0  0  0  0  0  0  0  0  0  0  0  0  0  0  0  0  0  0  0  0  0  0  0  0  0  0  0  0  0  0  0  0  0  0  0  0  0  0  0  0  0  0  0  0  0  0  0  0  0  0  0  0  0  0  0  0  0  0  0  0  0  0  0  0  0  0  0  0  0  0  0  0  0  0  0  0  0  0  0  0  0  1  1  1  1  1  1  1  1  1  1  20  20  9  5  1  1  
0  0  0  0  0  0  0  0  0  0  0  0  0  0  0  0  0  0  0  0  0  0  0  0  0  0  0  0  0  0  0  0  0  0  0  0  0  0  0  0  0  0  0  0  0  0  0  0  0  0  0  0  0  0  0  0  0  0  0  0  0  0  0  0  0  0  0  0  0  0  0  0  0  0  0  0  0  0  0  0  0  0  0  0  0  0  0  0  0  0  0  0  0  0  0  0  0  0  0  0  0  0  0  0  0  0  0  0  0  0  0  0  1  1  4  5  63  64  20  20  20  20  20  20  36  37  1  1  
0  0  0  0  0  0  0  0  0  0  0  0  0  0  0  0  0  0  0  0  0  0  0  0  0  0  0  0  0  0  0  0  0  0  0  0  0  0  0  0  0  0  0  0  0  0  0  0  0  0  0  0  0  0  0  0  0  0  0  0  0  0  0  0  0  0  0  0  0  0  0  0  0  0  0  0  0  0  0  0  0  0  0  0  0  0  0  0  0  0  0  0  0  0  0  0  0  0  0  0  0  0  0  0  0  0  0  0  0  0  0  0  1  1  9  5  53  54  67  20  20  20  43  1  1  1  1  1  
0  0  0  0  0  0  0  0  0  0  0  0  0  0  0  0  0  0  0  0  0  0  0  0  0  0  0  0  0  0  0  0  0  0  0  0  0  0  0  0  0  0  0  0  0  0  0  0  0  0  0  0  0  0  0  0  0  0  0  0  0  0  0  0  0  0  0  0  0  0  0  0  0  0  0  0  0  0  0  0  0  0  0  0  0  0  0  0  0  0  0  0  0  0  0  0  0  0  0  0  0  0  0  0  0  0  0  0  0  0  0  0  88  29  9  5  20  20  20  20  57  46  20  20  66  29  1  1  
0  0  0  0  0  0  0  0  0  0  0  0  0  0  0  0  0  0  0  0  0  0  0  0  0  0  0  0  0  0  0  0  0  0  0  0  0  0  0  0  0  0  0  0  0  0  0  0  0  0  0  0  0  0  0  0  0  0  0  0  0  0  0  0  0  0  0  0  0  0  0  0  0  0  0  0  0  0  0  0  0  0  0  0  0  0  0  0  0  0  0  0  0  0  0  0  0  0  0  0  0  0  0  0  0  0  0  0  0  0  0  0  89  33  9  5  20  20  20  20  46  20  20  20  51  52  1  1  
0  0  0  0  0  0  0  0  0  0  0  0  0  0  0  0  0  0  0  0  0  0  0  0  0  0  0  0  0  0  0  0  0  0  0  0  0  0  0  0  0  0  0  0  0  0  0  0  0  0  0  0  0  0  0  0  0  0  0  0  0  0  0  0  0  0  0  0  0  0  0  0  0  0  0  0  0  0  0  0  0  0  0  0  0  0  0  0  0  0  0  0  0  0  0  0  0  0  0  0  0  0  0  0  0  0  0  0  0  0  0  0  90  38  36  37  51  52  57  46  59  60  59  60  51  52  1  1  
0  0  0  0  0  0  0  0  0  0  0  0  0  0  0  0  0  0  0  0  0  0  0  0  0  0  0  0  0  0  0  0  0  0  0  0  0  0  0  0  0  0  0  0  0  0  0  0  0  0  0  0  0  0  0  0  0  0  0  0  0  0  0  0  0  0  0  0  0  0  0  0  0  0  0  0  0  0  0  0  0  0  0  0  0  0  0  0  0  0  0  0  0  0  0  0  0  0  0  0  0  0  0  0  0  0  0  0  0  0  0  0  1  1  1  1  1  1  1  1  1  1  1  1  1  1  1  1  
0  0  0  0  0  0  0  0  0  0  0  0  0  0  0  0  0  0  0  0  0  0  0  0  0  0  0  0  0  0  0  0  0  0  0  0  0  0  0  0  0  0  0  0  0  0  0  0  0  0  0  0  0  0  0  0  0  0  0  0  0  0  0  0  0  0  0  0  0  0  0  0  0  0  0  0  0  0  0  0  0  0  0  0  0  0  0  0  0  0  0  0  0  0  0  0  0  0  0  0  0  0  0  0  0  0  0  0  0  0  0  0  0  0  0  0  0  0  0  0  0  0  0  0  0  0  0  0  
